287
#########################
# @******   ######@  #  #
#*****#     *** **      #
#*****### #    C * # *I #
# # # #  *#   ### ##  * #
#P# # #   ###  # * # #  #
# # # *     >     B *##*#
#*# # * * ## ###***#  # #
# #   * * ## ###***#****#
#***********************#
#########################
