229
####################
#@*I#**** * ***    #
#***#   ********B#*#
#***#C  *********#*#
#***# ###          #
#***#* *#  *##**##*#
#***# *      ##*##P#
# ### **          ##
# >  # *  #  ### *@#
#***   *      # *  #
####################
