90
########################
# @    *  *********#* *#
# >    # ********* *#* #
#   **    *********#* *#
# #   B   *********#* *#
# *#*#    *********#* *#
#*#   C * *********#* *#
#  # #    *********#* *#
#I   *  @ ********* *P*#
########################
