400
####################
#@*   **        *  #
#*        *     *  #
#*      * * ### #  #
#* *   B      # ## #
#*     C      #  # #
#*  * *****    I   #
#  ##* *## *##**##*#
# ##  * #    ##*## #
#  *  ** P         #
# >  # *  #  ##  * #
#*                 #
# ## # ## #    # * #
#  *   * *********@#
####################
