121
#########################
#@    *    **           #
#*## ##     * *      *  #
#  ##   # * **   B   #  #
#*    * #    ### ### # *#
#   #    *#  ### #   # *#
# ###  #*  C  *      #  #
#  ##  *  * *    #   #  #
# *    # **#*#          #
#*# ##P #*#*  #*##  ##  #
# # *   * *   >       * #
# ### #*  # #  # ##### I#
# #   #   # # ##*  #*  ##
#* *       *      **   @#
#########################
