195
########################################
#************ @    *   *    **   *     #
#     *             C        *   #* * *#
###########  ########    ##    *##  #* #
#      ***   *   * >  *   *    *##* ## #
# ######       * * #    *# #* #  *     #
#       *   B    * #* ## # * ##    *##*#
# ######* ######  ##*##  #   #*    I## #
# *******   #@ * *   *  * P       *  **#
########################################
