250
########################################
#**********#        C        *    *#* *#
#**********# *   * >  *   *    *##* ## #
######## @ #   * * #    *###* #  *    @#
#            B   * #* ## # * ##  ##*##*#
# ######  ##     ###*##  #   #* ## I## #
# *   *        * *   *  * P       *  **#
#   ########***********### #####*******#
#*************#########***********# ####
#**************************************#
########################################
