324
##############################
#@******##     ##   * >******#
# #***# ##**  ##  *     ** # #
#*## ##   P #      * B     # #
#* # #  #  ### #*   *  ### #*#
#  *    #**    ## ## #       #
# ###   ###     # ## #  I ## #
#*  #    * *  C * ** ### ##  #
#*  #  #*******#***#*********#
#************************** @#
##############################
