438
########################################
#   * * *      C   **    *    *    ### #
#*****#            *       *    *  ### #
#*****#  *  *   *    B     #        ## #
#@****#     *       **     #  *   * ## #
###########       * **     #     #*    #
#     >   * ******************   ###   #
#   #    ### #  * # ###    #####*  * #P#
#  *# ##   # #  *##   # ##   #    # I# #
#*********************************@   *#
########################################
