132
#################
#      #**** *  #
# *   *#***    *#
# * B *#** ###  #
#* * **#***   * #
#*#****#** #   *#
#*#*#**#*#P## C #
###### #I#  #   #
#@******#> ****@#
#################
