371
################################
#***# **** ** ****** ****#** **#
#***#P        #####        C   #
#I**#    @                     #
# **############  *** *   #****#
# **#    #                     #
# **#            ** ****** ****#
# **# B      #  *** ** *** ****#
# **#    ****#           #######
# **# ** **  #            @ ***#
# **         # > **** *** *****#
################################
