319
#########################
#********************** #
#***** *  *  >   #  *## #
#I#    ## * @  ****## #P#
# ###**********###*# *# #
#*******# # *#**********#
# #        C      *###  #
# *   #* #  #**###*###**#
####* ## ## ##**## #@*#*#
#B          ************#
#########################
