186
#################
#******#@ ** *  #
####  ##*#*    *#
# * B ##*#####  #
# *    #******* #
# * *  #*# #   *#
# * #  #*#P#  C #
# * # I#*#  #   #
#  >    @# *    #
#################
