300
#########################
#  *  #*      **  * *   #
#  *  #***#@         #* #
#  *  #***#      #*  #  #
#     #***#        ###  #
#     #***#       #     #
#     #####    C * # *I #
# ###    *    ###  #  * #
#P###      ##  # * # #  #
# ### *     >     B *##*#
#*###   #  # ###   #  # #
# ###   #  # ### * #*   #
#********************* *#
#********************  @#
#########################
