95
##########################################
#**         #**#**#*#   *    **   *      #
#C*    *     **#**#*#         *    * * * #
#**         #**#**#*#           *   ##*  #
#**     ***   *   *     *   *    *  * ## #
#**# # ##   *   * * #>   *   * #  *      #
#**# # ##*##  B   * #* ## # * ##    *##* #
#**# # ##  ##  ## ###*##  #   #* ## I##  #
#***   *        * *   *  * P       *  ** #
##########################################
