186
#########################
#**********************@#
#*     **            #* #
#  *    *   ######*  #  #
#     #    *######*###  #
#     ### #    C * # *I #
# ### #  *#   ###  #  * #
#P### #   ###  # * # #  #
# ### *     >     B *##*#
#           *          @#
#########################
